#Word	#Class	#Definition
Contrite	adj.	過意不去的
Deftness	adj.	靈巧
Solace	n./v.	安慰，緩和
incarcerate	v.	監禁
Smuggle	v.	走私
autism	n.	自閉症
Flaccid	adj.	鬆弛，鬆軟
scrutinize	v.	仔細檢查
fatigue	n./v.	疲勞疲倦
self-effacing	adj	自我掩飾
endow	v	賦予
prescience	v	預知
obduracy	adj	固執
tractable	adj	順從的
insofar_as	prop	因為
subordinated	adj	從屬
attributable	adj	可歸屬
disinterested	adj	公正的
exacting	adj	嚴格的
grumble	v	抱怨
inattentive	adj	不專心
circumspect	adj	謹慎的
flustered-about	adj	慌亂
altruistically	adv	有利他人主義的
dismissal	v	不予理會
conviction	v	堅信
compound	v	混合
obviate	v	取消
displace	v	取代
patent	n.	專利的
now-that	prop	由於
rallied-to	adj	團結
communal	adj	相互的，共同的
relish	v	享受
choreographed	adj	精心安排
rattle	v	使不安
bolster	v	促進
hail	v	稱讚
acclaim	v	稱讚
inconsequential	adj	不重要的
capricious	adj	任意的，任性的
undisclosed	adj	保密
proscriptive	adj	嚴格的
inflexible	adj	僵化
contract	v	感染
puncture	v	戳穿
facile	adj	膚淺
premise	v	前提
stingy	adj	吝嗇
provocative	adj	激怒的
copious	adj	豐富的
elusive	adj	難以理解的
approbation	n	認可
vernacular	n	大眾語言
electorate	n	選民
malleable	adj	易受影響的
faunas	n	動物群
standstill	adj	停止，停滯
vacuous	adj	空洞的
mirthful	adj	愉快的
gloomy	adj	憂鬱的
jovial	adj	歡快的
spurious	adj	假的
conjectural	adj	猜測的
impalpable	adj	感受不到的
ephemeral	adj	短暫的
unqualified	adj	！完全的，無條件的！,沒有資格
perforce	adj	必須，一定
anathema	adj	極其討厭
unpropitious	adj	不吉利
meretricious	adj	華而不實
anthropomorphism	n	擬人論
exacerbated	adj	使惡化
supposition	n	假設，想法
primate	n.	靈長類，主教
exhaustive	adj	詳盡的，累壞的
rudimentary	adj	初級的
spiteful	adj	惡意的
conversely	adv	相反的
ramification-of	n	衍生
interminable	adj	無盡的
invariably	adv	不變的，一律的
tendentious	adj	有傾向的
dubiously	adv	半信半疑的
nuanced	adj	細節的
lyrical	adj	狂熱的
ornate	adj	裝飾華麗的
onerous	adj	繁重的
plethora	n	過多，過剩
surfeit	n	過量，過剩
rigor	n	嚴謹
chagrin	n	懊惱
stagnated	adj	停滯
ostensibly	adj	表面上，明顯的
belie	v	掩飾
dispel	v	打消
lapse	n	失誤
slighted	adj	被輕視
pretentious	adj	炫耀的
snubbed	adj	被冷落，被怠慢
heterogeneity	n	非均質，異質類
voracious	adj	狼吞虎嚥，貪婪的
omnivorous	adj	無所不食的
prodigal	adj	揮霍的
notwithstanding	prop	儘管
genteel	adj	有教養的
affable	adj	和藹可親的
vehement	adj	激烈的
sagacious	adj	睿智的
pessimistic	adj	悲觀的
obliterate	v	消除
bewilder	v	使。。迷惑
sanguine	adj	樂觀的
flummoxed	adj	困惑的
heartened	adj	受鼓舞的
empirical	adj	以經驗為依據的
paradigmatic	adj	典範的
obtuseness	n	遲鈍
equivocations	n	含糊其詞
contrail	n	飛機的軌跡
benighted	adj	愚昧無知
multitudinousness	n	多樣性
mendacity	n	謊言
guilelessness	n	樸實
abnegation	n	拒絕
entail	v	使。。必然發生
squander	v	揮霍
supplant	v	取代
promulgate	v	頒布
corroborate	v	證實
mold	n	模型
derogate	v	貶值
abet	v	慫恿
instigate	v	發起訴訟，刺激
impede	v	阻礙
cajole	v	誘勸
conceivable	adj	可相信的
plastic	adj	可塑的
imitable	adj	可以模仿的
disparate	adj	迥然不同的
recapitulate	v	概括
forswear	v	放棄
respite	v.	緩解，暫止
Tepid	n	溫暖的，不熱情的
lugubrious	adj	哀傷的
Avow	v	坦率承認
prevail	adj	流行，勝過，勸說
bemuse	v	使困惑
abound	adj	大量存在
dispassionately	adv	客觀冷靜的
subverted	v	顛覆
complemented	v	補充
underscored	v	強調
jettison	v	放棄
stem-from	v	起源
afflicting	adj	使痛苦
prominence	n	著名的
salience	n	顯著，突出，特點
pecuniary	adj	金錢的，錢財方面的
quixotic	adj	不切實際的
envisage	v	設想
abeyance	n	中止
abstemious+	adj	有節制的
acumen	n	敏銳
adulation	n	諂媚
affinity	n	緊密聯繫，類同，吸引
aghast	adj	驚駭的
agreeable	adj	令人愉快，合適的
alacrity	n	樂意
allure	v	引誘，魅力
Ameliorate	v	改善
animadversion	n	批評
antagonistic	adj	敵對的
anthropogenic	adj	人為的
ape	v	模仿
aplomb	n	鎮定，泰然自若
aprocryphal	adj	虛假的
apposite+	adj	合適的
archaic	adj	古老的
artless	adj.	純真的，樸實的
assuage	v	減輕，緩和
astringent	adj	嚴厲的
auspicious	adj	吉兆的，吉利的
austere	adj	樸素的
avert	v	避開，移開，防止
awry	adv	出錯的，歪斜的
baffle	v	使困惑
reminiscent-of	n	使人聯想的
jejune	adj	枯燥乏味
buttress	v	支持
fabled	adj	寓言的
convention	n	習慣,公約，大會
gentility	n	紳士
disparaged	adj	貶低
imperialist	n	帝國主義
punctiliousness	n	一絲不苟的
prolixity	n	冗長的
sophist	n	詭辯者
quibbler	n	吹毛求疵者
pedant+	n	書呆子
antebellum	adj	南北戰爭前的
artificial	adj	虛假的
unambiguous	adj	不模糊的
clear-cut	adj	明顯的
totemic	adj	象徵意義的
iconoclastic	adj	反對偶像崇拜的,破舊立新的
emblematic	adj	象徵的
acute	adj	嚴重的
exiguous+	adj	稀少的
overstated	adj	誇張的
unrelenting	adj	不屈不饒的
susceptible	adj	易受影響的
breadth	n	寬度
amass	v	積聚
pejorative	adj	輕蔑的
boycott	n	抵制
concur	v	同意，一致
qualify	v	限制
wedge	n/v	楔入，擠入
reclamation+	n	再生，再造
rehabilitation	n	修復，復興
retraction	n	撤回，縮回
scholarship	n	學問，學識，學術研究
intellectual	n	知識份子
sensation	n	轟動，激動，感知
marionette	n	牽線木偶
proteges	n	被保護的人，門徒
proprietary	adj	專有的
self-perpetuating	adj	自續的
tract	n	大片土地，房產
convulsion	n	動亂，震動，抽搐
exorbitance	n	過高，過度
opulence	n	財富
lurch	v/n	突然傾斜，蹣跚
slump+	v/n	下降，倒下，陷落
inclusiveness	n	包容
stratification	n	階層化
sanctimonious	n	假裝虔誠
innocuous	n	無毒，無害，無傷大雅的
undercut	n/v	切除。。的下部，暗中破壞，廉價出售
prefigure	v	預示，徵兆
banal	adj	陳腐的，平凡的
baneful	adj	有害的
bedrock	n	基礎
beholden	adj	蒙恩的，負債的
belligerent	adj	好戰的
bemoan	v	埋怨
betoken	v	表示
blemish	v	污點
bogus+	adj	偽造的
bookish	adj	書呆子氣質的
boon	n	好處，恩惠
brandish	v	炫耀
brook	v	容忍
bucolic	adj	鄉村的
budding	adj	萌芽期的
buoy	v	使振奮
burgeon	v	迅速生長
canned	adj	無新意的
caterwaul	v	叫春，求愛
chastise	v	嚴厲批評
chimera	n	幻想
circumscribe	v	限制
circumstantial	adj	依情況而定
clandestine	adj	秘密的
clot+	v	凝結
cluster	v	聚集
collude	v	串通
commonplace	n	常見，陳詞濫調
compartmentalize	v	分開
composed	adj	鎮定的
compromise	n	妥協，危害
concede	v	承認
conciliatory	adj	願意和解的
conspicuous	adj	顯眼的
construe	v	詮釋，分析
consummate	adj	完美的
contemplate	v	深入思考的
contentious	adj	愛爭議的
contingent	adj	不確定的，偶然的
conundrum+	n	複雜難解的問題
convulsion	n	動亂
covet+	v	貪求
crass	adj	愚鈍的
crestfallen	adj	氣餒的，低頭的
cursory	adj	草率的
curtail	v	縮減
perennial	adj	終年的，長年的
lingering	adj	拖延的
absolving+	adj	免除
detract-from	v	減損
stifle+	v	束縛
enliven	v	鼓舞
cede-to+	v	讓給
ascribed-to	v	歸因於
aspersion	n	誹謗
commendation	n	表揚，讚賞
slur	v	誹謗，忽視
stave-off	v	擊退，趕走
concede	v	承認
coddle	v	溺愛
excoriate	v	譴責
mollify	v	安慰
delude	v	欺騙
gravity	n	嚴肅，重大
decidedly	adv	確定的
diverting	v	逗。。開心
grimy	adj	污穢的
unblemished	adj	無瑕疵的
limpid	adj	清澈的
pellucid	adj	清澄的，透明的
remedy	v	修復
tout	v	吹捧
impugn	v	抨擊
contention	n	爭吵
quackery	n	騙人行為
cronyism	n	裙帶關係
nepotism	n	裙帶關係
duplicity+	n	虛偽
rectitude	n	公正
probity	n	誠實
magnanimity	n	寬宏大量
perspicacity	n	洞察力
detachment	n	超然，客觀
pandemonium	n	地獄，嘈雜
posse	n	一群人
anatomize+	v	詳細分析
deficit	n	赤字
far-fetched	adj	牽強的
inexplicable	adj	無法說明的
decrepitude+	n	衰老
defame	v	誹謗
deflect	v	使轉向
degrade	v	貶低，腐蝕
deify	v	神化
demise	n	終止，死亡
demur+	v	表示反對
deter	v	威懾
detestation	n	憎惡
detract	v	減損，貶低
devolve+	v	權力下放，衰落
diatribe	n	抨擊
diffident	adj	缺乏自信的，言行謹慎的
diffuse	v	傳播，分散，
dilatory+	adj	拖延的
dire	adj	恐怖的
disintegrate	v	瓦解
disorganize	v	擾亂
dispute	v	爭吵，質疑
disregard	v	忽視，貶低
dissemble+	v	偽裝
distend++	v	膨脹
distinctive	adj	特別的
douse	v	熄滅
dovish	adj	和平主義的
dreary	adj	枯燥乏味的
droll	adj	滑稽的
ebb	v	衰退
eclipse	n	衰退，勝過
economy	n	節約
egalitarian	adj	平等主義的
egregious	adj	臭名昭著的
elate+	v	使。。高興
embody	v	象徵，包括
emendation	n	修訂
emergent	adj	意外的，新興的
emulate	v	模仿，努力趕超
enamor+	v	使。迷戀
encomium	n	讚美
encumber+	v	妨礙
endemic	adj	地方性的
engender+	v	導致
entrench+	v	使牢固，確立
equable	adj	平靜的
equanimity+	n	鎮定
errant	adj	不定的，行為錯誤的
erstwhile	adj	過去的
espouse	v	擁護
Evanscent	adj	短暫的
evenhanded	adj	公平的
exactitude	n	正確性，嚴謹
excoriated+	v	嚴厲指責
exigent	adj	迫切的
explicit	adj	直接了當的，詳述的
extirpate	v	根除
extraneous	adj	無關的
self-interest	adj	自私自利的
dub+	v	稱為，叫做
reprehensible	adj	受譴責的
repertoire+	n	個人曲目
dampen	v	抑制
deaden	v	使。。減弱
rehash+	v	重新處理
untoward	adj	異常的
unprecedented	adj	前所未有的
squelch	v	鎮壓
collegial	adj	集體的
outmoded	adj	過時的
specimen	n	標本
elucidate+	v	闡明
demarcate	v	劃出界線
panoply	n	巨大數量
evince	v	表明
disconcerting	adj	令人不安
hastily	adv	匆忙的
evocatively	adv	喚起的
preordained	adj	注定的，不能避免的
quartet	n	四重奏
credulousness	n	輕信
corollary	n	對。。的推斷
confer	v	授予
graze	v	吃草，放牧
collegiality	n	共同掌權
suppleness	n	柔軟
exuberant	adj	熱情洋溢的，過度的
fealty	n	忠誠
fester++	v	惡化
fickle	adj	善變的
flagrant	adj	明目張膽的
shrewdness	n	精明
lambaste	v	痛打，嚴懲
irascibility	n	易怒
insouciance	n	無憂無慮
surreptitiousness	n	秘密，偷偷摸摸，鬼鬼祟祟
pollination	n	授粉
impediment	n	妨礙，阻礙
malady+	n	病，疾病，社會腐敗
recede	v	後退
rambling	adj	冗長含糊的
crisp	adj	脆，酥，鮮嫩
wayward	adj	任性的，難以控制的
urbane	adj	都市化的，彬彬有禮的
shading	n	細微變化
analogue	n	相似物
wherewithal	n	必要資源
solemnity	n	莊重
panache	n	羽飾，誇示；假威風
hedged	n	模稜兩可的話,障礙物，界線
scrutiny	n	仔細，審查
expedit	v	促進
facilitate	v	促進
mainstay	n	支柱
illusory	adj	幻覺的
sever	v	切斷，分隔開
imputed	v	歸罪於，歸因於
introspective	adj	內省的
fleeting	adj	短暫的
flout	v	公然蔑視
flummery	n	假恭維，胡言亂語
forgo	v	放棄
formidable	adj	可怕的，令人敬畏的，難對付的
forsake	v	拋棄
frugal	adj	簡樸的
fungible	adj	可取代的
futile	adj	無用的
garrulous	adj	喋喋不休的
hallow	v	極其崇敬
hamstring	v	使無能為力
hasty	adj	匆忙的，草率的
hedge	v	迴避
heed	v	注意，留心
heterodox	adj	異端的
hidebound	adj	迂腐守舊的
high-minded	adj	高尚的，傲慢的
hitch	n	故障
hodgepodge	n	大雜燴
hortatory	adj	勸告的
immense	adj	巨大的
impecunious	adj	貧窮的
imperil	v	危及
implacable	adj	不能安撫的，難和解的
impolitic	adj	不明智的
indebted	adj	感激的
indiscriminate	adj	肆意的，盲目的
inhibit	v	抑制，禁止
inscrutable	adj	難以理解的
insular	adj	狹隘的
intermediary	adj	調解的，中間的
interweave	v	交織
intimate	v	暗示
involved	adj	複雜的
irascible	adj	易怒的
irenic	adj	和平主義的
itinerant	adj	流動的，巡迴的
keep-abreast-of	phrase	了解最新情況
kindred+	adj	同類的，相似的
kinfolk	n	親戚
languish	v	失去活力，被忽視
lapse	n	錯誤，行為失檢，短暫終止
layperson	n	門外漢
lethargic	adj	無精打采的
lionize	v	崇拜，把。。視為名人
list	v	傾斜
long-winded	adj	冗長的
loquacious	adj	健談的
ludicrous	adj	荒唐可笑的
lull	v	使平靜，蒙蔽，間歇
luxuriant	adj	茂盛的，豐富的
malinger	v	裝病
malodorous	adj	難聞的
manacle	v	束縛
marginal	adj	不重要的，邊緣的
martinet	n	嚴格執行紀律的人
materialize	v	顯現，實現
mount	v	增加
mudlle	v	使。。混亂
mundane	adj	平凡的，乏味的，世俗的
nascent	adj	剛出現的
naysayer	n	唱反調的人
nebulous	adj	模糊的
negligent	adj	疏忽大意的
negligible	adj	微不足道，不重要的
nettle	v	激怒
nimble+	adj	敏捷的，敏銳的
nondescript	adj	難以歸類，難以形容，單調的
numinous	adj	神聖的，超自然的
obeisance	n	尊敬
obfuscate	v	混淆，使。。迷惑
objectionable+	adj	令人反感的
obscure	adj	不出名的，費解的
obsequious	adj	諂媚的
obtrusive	adj	強迫人的，出風頭的，顯眼的
occlude+	v	阻塞
ominous	adj	不詳的
omit	v	遺漏
onetime	adj	過去的
onset	n	開始
oppressive+	adj	殘酷的，令人窒息的
opprobrium	n	譴責，恥辱
opulent	adj	富裕的，豪華的，奢侈的
orientation	n	目標，態度
outdo	v	超過
outstrip	v	超過
overshadow	v	遮暗，使。。黯然失色，超越
overthrow	v	打倒，推翻，廢除
pacific	adj	和平主義的
palliate+	v	減輕
partisan	adj	有偏見的
pastiche+	n	大雜燴
pastoral	adj	鄉村的
patchwork	n	拼湊成的東西大雜燴
pathetic	adj	可憐的
peculiar	adj	奇怪的
pedigree+	n	身世
penchant+	n	傾向，嗜好
peripheral	adj	邊緣的
perspicacious	adj	有洞察力的
pervasive	adj	普遍的，瀰漫的
plague	n	讓人討厭的東西，困擾
plaintive	adj	悲傷的
plastic	adj	做作的，可塑的
portend	v	預示，表示
posture	n	態度，擺姿態
precarious	adj	危險的，不穩固
precede	v	比。。先發生
precipitate	v/adj	衝動的，魯莽的，引發，加速，沈澱，
predilection+	n	偏愛
prefigure	v	預示
preside+	v	主持
pressing	adj	緊迫的，重要的
presage	v	預示
preternatural	adj	異乎尋常的
pretext+	n	藉口
prevaricate	v	支吾，說謊
proclivity	n	傾向，嗜好
profess	v	公開宣稱，信封
profligate	adj	揮霍的
profusion	n	大量
prolix	adj	冗長的
proponent	n	支持者
protract+	v	拖延，延長
provincial	adj	狹隘的，省的
provisional	adj	臨時的
pseudonym	n	筆名，假名
pugnacious	adj	好鬥的
purveyor	n	供應商
purview+	n	範圍
quaff	v	痛飲
quash+	v	平息，否決
quirky	adj	奇怪的
raillert	n	開玩笑
rant	v	咆哮，嚴厲批評
rapacious+	adj	貪婪的
rapprochement	n	和解
recalcitrant+	adj	倔強反抗的
recoil	v	畏縮，報應，反彈
recrudescent	adj	復發的
rein	v	統治，控制
relinquish	v	放棄
render	v	呈現，再現
repudiate	v	拒絕承認，與。。斷絕關係
restive	adj	躁動不安的
riddle	n	謎
row+	n	爭吵
sacrosanct	adj	神聖不可改變的
scant	adj	缺乏的
self-defeating	adj	自我挫敗，弄巧成拙，不利於自己
seminal+	adj	開創性的
senescence	n	衰老
sham	n	假東西，贗品
shoddy	adj	粗製濫造的
sidestep	v	迴避
skittish	adj	易受驚的
sleazy	adj	骯髒的，邪惡的，不誠實的
slippery	adj	不可靠的，難以抓住的
slur	n/v	貶低，忽視
snag	n	障礙
snobbish	adj	勢利的
somnolent	adj	昏睡的，催眠的
stale+	adj	陳舊的，厭倦的
stanch+	v	止血，平息
staunch	adj	堅定的，忠臣的
sterling	adj	優秀的
stymie	v	阻礙
subsidize+	v	資助，補貼
succumb	v	屈服，死亡
supple	adj	能適應的，柔韌的
surly	adj	陰鬱的
surmise+	v	推測，猜測
sweeping	adj	徹底的
sycophantic	adj	諂媚的
synoptic	adj	概要的
perfidious	adj	不誠實的，背棄信義的
mere	adj	只有
strewn-with+	v	散播
import	n	重要性
stupefaction+	n	麻木
certitude	n	確信
beset	v	困擾，圍攻
foreordain	v	注定，預先注定
elusive	adj	逃避的
preliminary	adj	預備的
deflate	v	平息
awash	adj	充斥著
sound	v	發聲，健全的，完好的
shrilled+	adj	尖聲的，刺耳的，強烈的，不安的
scaremonger	n	謠言散布者
vitiate+	v	損害，污染，使。。無效
porous	adj	多孔的
preventive	adj	預防的，防病的
prophylactic	adj	預防疾病的
immaterial	adj	不重要的，非物質的
follow-with	v	延續
smallpox	n	天花
seamy	adj	污穢的，有縫的
underside	n	陰暗面
escapist	n	逃避主義
gripping	adj	吸引人的
expeditious	adj	迅速的
hindsight	n	事後的認識
cavalier	adj/n	漫不經心，傲慢的，騎士
machination	n	陰謀，策劃
tantamount	adj	同等的
subservient	adj	屈從的
implicated	adj	牽涉的
aversion	n	厭惡
enterprising	adj	有魄力，有膽量的
resignation	n	放棄，順從
idiosyncratic	adj	有氣質的，有特性的
rote	n	死記硬背
felictious	adj	恰當的
albeit	adv	儘管
putative+	adj	想像的，推定的
understatement	n	低調保守
compunction	n	良心責備
solidarity	n	團結，一致
blinder	n	馬的眼罩
haphazardly	adv	偶然的，隨意的
peregrinate	v	遊歷，旅行
verisimilitude	n	貌似真實，逼真的事物
wanton	a	惡意的，肆無忌憚的，不節制的，過分的
monstrous	a	怪異的，醜陋的，可怕的，巨大的
plunder	v	掠奪，侵吞，竊取
beguile	v	欺騙，使著迷，使時間過的愉快
impassion	v	激起。。的熱情
anticipate	v	先於。。的行動，預期，期望
unprepossessing	adj	不討人喜歡，不吸引人的
contemptuous+	adj	輕蔑的，瞧不起的
accession	n	就職，攻擊，登基，同意，獲得，感情爆發，接近
capacious	a	容量大，寬闊的，心胸寬大的
eruption	n	爆發
lest	conj	唯恐，免得，擔心
siphon-off/out	v	吸出，抽乾
physiological	adj	生理學的
oeuvre	n	作品，畢生之作
terse+	adj	簡短的
inexorable+	adj	無法改變的，無動於衷的
unyielding	adj	不屈服的，不讓步的，頑固的，堅挺的
dichotomous	adj	分成兩個的，不相符的
fickle	adj	善變的
flighty+	adj	愛發幻想的，輕浮的，古怪的，易怒的
wane+	v	衰老，減少
cower	v	畏縮
nonconformist	n	不守成規者
exasperation	n	惱怒
unwieldly	adj	笨重的，難操作的
all-encompassing	adj	包羅萬象的
alarmist	n	危言聳聽者
acquiescence	n	默許，默認
goose-bumps	n	雞皮疙瘩
fiery	adj	熱烈的，暴躁的
vexation	n	煩惱，苦惱，惱火
unalloyed	adj	非合金的，未參雜的，純粹的，真正的
scold	v	責罵，斥責
devoid	adj	缺乏
vicavicous	adj	活潑的，快活的
slumberous	adj	像要睡覺的，沈睡的
arousal	n	喚起，覺醒，激勵
maudlin+	adj	容易流淚的，情感脆弱的
helter-skelter	n/adj	倉促忙亂的
indecorous	adj	無禮的，不和禮節的
somber+	a	昏暗的，陰沈的，嚴峻的，顏色黯淡的
mien	n	風采，態度，外表，樣子
cardinal	adj	重要的，主要的，基本的
persona	n	小說中的人物，角色
wondrous	adj	奇妙的
conform-to	v	順從，遵從，與。。一致
exculpate	v	開脫罪行
venal+	adj	貪污的，唯利是圖的
unfathomable	adj	不可理解，深不可測的
irresolution	n	猶豫不決
inscrutable	adj	難以理解的
no-nonsense	adj	正經的，嚴肅的，直接了當的
misnomer	n	名稱誤用
morbid	adj	疾病的，病態的，恐怖的
appropriate	v	挪用，合適的
perverse	adj	墮落的，邪惡的，倔強的
insouciant	adj	漫不經心，不在乎的
captive	n	俘虜，囚徒，著迷的人，受控制的人
levity	n	輕浮，輕率，不穩定
overblown	adj	己盛開過的，肥大的，過分的，平息的
topple	v	使倒塌，推翻，顛覆
archetypical	adj	原型的
merriment	n	歡笑，歡樂
remiss	adj	疏忽的，不小心的，無力的
unduly	adj	過分的，過度的
conform	v	遵守，遵照，適應
tribute	n	進貢，敬意，尊崇
rancor	n	敵意，憤恨
unidimensional	adj	一維的
drollness	n	滑稽
congeniality	n	意氣相投
stoicism	n	嘲弄
bollyhoo	n/v	大肆宣傳，喧鬧
slacken	v	放鬆，減緩，減弱
spur	v	刺激，鼓舞
encoding-of	v	處理信息
advent	n	出現，極度再臨
mercurial	adj	易變的，敏捷的
blithe	adj	歡樂的，快活的，無憂無慮，漫不經心的
megalomaniacal	adj	自大的
indolent	adj	懶惰的
disposition	n	性格，傾向，排列，支配，消除，贈予
prognosis	n	預知
glib	adj	膚淺的
authoritarian	n	權力主義
veracity	n	誠實
cliquish	adj	分派的
heightened	adj	得到提高
inert	adj	無生命的，呆滯的
accede-to	v	同意
meddle-with	v	干涉
square-with	v	與。。一直
aver+	v	宣告為確實，斷言，堅稱
in-that	phrase	由於
bearing	n	行為舉止
truculent	adj	好鬥的
tenfold	adj	十倍的
brood+	n/v	一窩，一夥人，沈思，盤算
peccadillo	n	輕罪，小瑕疵
reparation	n	賠償，修理
standing	n	地位
fray+	n	磨損，惱火
stewed-in+	phrase	焦慮
confounding	adj	混雜的
taint	v	腐敗，敗壞，感染
hectic	adj	興奮的，發熱的
discretely	adv	分離的
utilitarianism	n	實用主義
historicism	n	歷史決定論
averse	v	反對的，不願的
irk+	v	使厭倦，使苦惱
asset	n	資產，財務
sabotage	v	破壞，妨礙
maintain	v	堅持，聲稱
For-all	phrase	儘管
skirt	v	避開
scathing	adj	上海的，損傷的，嚴格的
subversiveness	n	顛覆
satirize	v	諷刺，挖苦
aspirant	n	追求者
delegate	v/n	委託，授權，代表
progressive	adj	進步
reactionary	adj	保守的，反動的
populist	n	平民主義
efficacious	adj	有效的
adduce	v	引用
entailed-by	v	繼承，使。。承擔
antecedent	adj	在。。之前，經歷，學歷
bleaker	adj	荒涼的，無遮蔽的，陰冷的，冷酷的，乏味的 
inextricably	adj	逃脫不掉，無法解決的，複雜的
customary	adj	習慣的
commandeer	v	強行徵募
cavil	n	吹毛求疵，苛責，無端指摘
diametrically	adj	直徑的，正相反的
warble	v	用顫音唱
shriek	v	尖叫
croon	v	低聲唱，輕哼
disarray	v	混亂
unruliness	n	任性，難以控制
slumber	v	睡眠，禁止狀態
blatant	adj	喧鬧的，公然的，刺眼的，炫耀的
fiscal	adj	財政的，會計的
prudence	n	慎重
melancholy	n/a	憂鬱的
concession	n	讓步，承認
exigency	n	緊急狀態，迫切需要
dietitian	n	營養學家
culinary	adj	烹飪的，廚房的
jar	n/v	發出刺耳聲音，不一致，使人不爽，震動
roil+	v	攪渾，使。。不安
literacy+	n	知識，能力
conjure-up+	v	使人想起
heartfelt	adj	衷心的，真誠的
incinerator	n	焚化爐
frenzy	n	瘋狂，狂怒，狂熱
pitfall	n	危險，陷阱
cynicism+	b	譏笑
labyrinth	n	迷宮，從縱複雜，迷路
bludgeon	n/v	欺負，恐嚇
crabbed	adj	難懂的，不高興，暴躁
diffident	adj	優柔寡斷
trace	n	微量，絲毫
judicious	adj	明智的，明斷的
motley	adj	雜色的
mawkishness	n	令人作嘔
austerity	n	嚴格，樸素
entice	v	誘使，慫恿
gall	v	怨恨，苦味，膽汁，惡毒，惱怒
placate	v	安撫
appease	v	平息，緩和，滿足
rankle+	v	使疼痛，使怨恨
uncanny	adj	奇怪的，可怕的，神奇的
pervaded	adj	瀰漫於
cordiality+	n	熱誠
conviviality	n	歡樂
barring	adj	除。。以外
autonomy	n	自治
upshot	n	結果，結局，要點
fret	v	使苦惱，侵蝕
beneficence	n	善行
fecundity	n	多產，豐饒
regurgitate	v	湧回，反胃，反芻
solicitous	adj	熱心的
recast	v	重鑄，重訂
comical	adj	滑稽的，詼諧的，古怪的
unwitting	adj	不知情的
hefty	adj	重的，肌肉發達的
preempted	adj	搶佔，先發制人
supersede	v	取代
preface	v	以。。開始
fraught	adj	擔心，憂慮的，充滿的
enviable	adj	可羨慕的
backwater	n	與世隔絕，落後的地方
sonorous	adj	響亮的
clamorous	adj	吵鬧的
invidious	adj	有害的，招致不滿的，誹謗的
crow	n/v	烏鴉，歡呼，幸災樂禍
ogre	n	怪物
adverse	adj	相反的，不利的，有害的
peopled。。with	v	充滿
tonic	adj	滋補的，使人振奮的
sculptor	n	雕刻家
compliant	adj	順從的
augur	v	預兆
heedless	adj	不留心，不注意
incendiary	adj	縱火的，煽動的
dazzling	adj	耀眼的
strenuously	adv	積極的
tort	n	侵權行為
litigation	n	訴訟
spirited	adj	生氣勃勃的
retinue	n	跟隨者
meld	v	合併
spearhead	n/v	先鋒部隊，帶領
trepidation	n	慌張，不安
tenacity+	n	韌性
plummeted	adj	垂直下降，急速減少
oracular	adj	神諭的，難懂的
aggravate	v	加劇，惡化，激怒
impassive	adj	無感情的
draconian	adj	嚴格的
rapacious	adj	貪婪的，強取的
savage	adj	野性的，原始的，粗魯的，荒涼的
condescending	adj	居高臨下的
hysteria	adj	情緒爆發，歇斯底里
vilify	v	詆毀
extol	v	讚揚
umbrage	n	生氣
unexampled	adj	前所未有的
polemic	n	猛烈抨擊，態度鮮明
economic	adj	有利可圖的
stasis	n	停滯
factious	adj	分黨派的
colossal	adj	巨大的
misgiving	n	疑慮，擔憂
analytical	adj	善於分析的，客觀冷靜的
balk-at	phrase	迴避
mordant	adj	尖酸刻薄的
untether	v	脫離
qualm	n	不安
prompt	v/adj	促使，敏捷的
flush-with	phrase	臉紅
indignant	adj	憤怒的
resuscitate	v	使。。復甦
upend	v	顛倒，倒立，混亂
amenable	adj	肯順從的，經得起考驗的
luminary	n	聰明的人，發光體
exegesis	n	解釋，註釋
distill	n	蒸餾
dispatch	adj/v	迅速的，派遣
tedious	adj	單調乏味的
stun	v	使，驚訝
hortatory	adj	勸告的
badger	v	煩擾，反覆勸說
debase	v	貶低
strain	v	盡力，拉緊，過度勞累
utter	v/adj	表達，完全的
redouble	v	大量增加
panegyrgic	adj	頌揚的
rebuke	v/n	指責，阻礙，阻止
revert	v	回覆，復舊，重提，歸還
resort	v	訴諸，憑藉，求助
